6,6,6,6,6,6,6,6,6,6,6,6,6,6,6,6,6,6,6,6,6,6,6,6,6,6,6,6,6,6,6,6,6,6,6,6,6,6,6,6,6,6,6,6,6,6,6,6,6,6,6,6,6,6,6,6,6,6,6,6,6,6,6,6,6,6,6,6,6,6,,12,12,11,11,11,11,11,11,11,11,11,11,11,11,11,11,11,11,11,11,11,11,11,11
6,6,6,6,6,6,6,6,6,6,6,6,6,6,6,6,6,6,6,6,6,6,6,6,6,6,6,6,6,6,6,6,6,6,6,6,6,6,6,6,6,6,6,6,6,6,6,6,6,6,6,6,6,6,6,6,6,6,6,6,6,6,6,6,6,6,6,6,6,6,,12,12,11,11,11,11,11,11,11,11,11,11,11,11,11,11,11,11,11,11,11,11,11,11
6,6,6,6,6,6,6,6,6,6,6,6,6,6,6,6,6,6,6,6,6,6,6,6,6,6,6,6,6,6,6,6,6,6,6,6,6,6,6,6,6,6,6,6,6,6,6,6,6,6,6,6,6,6,6,6,6,6,6,6,6,6,6,6,6,6,6,6,6,6,,12,12,11,11,11,11,11,11,11,11,11,11,11,11,11,11,11,11,11,11,11,11,11,11
6,6,6,6,6,6,6,6,6,6,6,6,6,6,6,6,6,6,6,6,6,6,6,6,6,6,6,6,6,6,6,6,6,6,6,6,6,6,6,6,6,6,6,6,6,6,6,6,6,6,6,6,6,6,6,6,6,6,6,6,6,6,6,6,6,6,6,6,6,6,,12,11,11,11,11,11,11,11,11,11,11,11,11,11,11,11,11,11,11,11,11,11,11,11
6,6,6,6,6,6,6,6,6,6,6,6,6,6,6,6,6,6,6,6,6,6,6,6,6,6,6,6,6,6,6,6,6,6,6,6,6,6,6,6,6,6,6,6,6,6,6,6,6,6,6,6,6,6,6,6,6,6,6,6,6,6,6,6,6,6,6,6,6,6,,12,11,11,11,11,11,11,11,11,11,11,11,11,11,11,11,11,11,11,11,11,11,11,11
6,6,6,6,6,6,6,6,6,6,6,6,6,6,6,6,6,6,6,6,6,6,6,6,6,6,6,6,6,6,6,6,6,6,6,6,6,6,6,6,6,6,6,6,6,6,6,6,6,6,6,6,6,6,6,6,6,6,6,6,6,6,6,6,6,6,6,6,6,6,,12,11,11,11,11,11,11,11,11,11,11,11,11,11,11,11,11,11,11,11,11,11,11,11
6,6,6,6,6,6,6,6,6,6,6,6,6,6,6,6,6,6,6,6,6,6,6,6,6,6,6,6,6,6,6,6,6,6,6,6,6,6,6,6,6,6,6,6,6,6,6,6,6,6,6,6,6,6,6,6,6,6,6,6,6,6,6,6,6,6,6,6,6,6,,12,11,11,11,11,11,11,11,11,11,11,11,11,11,11,11,11,11,11,11,11,11,11,11
6,6,6,6,6,6,6,6,6,6,6,6,6,6,6,6,6,6,6,6,6,6,6,6,6,6,6,6,6,6,6,6,6,6,6,6,6,6,6,6,6,6,6,6,6,6,6,6,6,6,6,6,6,6,6,6,6,6,6,6,6,6,6,6,6,6,6,6,6,6,,12,11,11,11,11,11,11,11,11,11,11,11,11,11,11,11,11,11,11,11,11,11,11,11
6,6,6,6,6,6,6,6,6,6,6,6,6,6,6,6,6,6,6,6,6,6,6,6,6,6,6,6,6,6,6,6,6,6,6,6,6,6,6,6,6,6,6,6,6,6,6,6,6,6,6,6,6,6,6,6,6,6,6,6,6,6,6,6,6,6,6,6,6,6,,12,11,11,11,11,11,11,11,11,11,11,11,11,11,11,11,11,11,11,11,11,11,11,11
6,6,6,6,6,6,6,6,6,6,6,6,6,6,6,6,6,6,6,6,6,6,6,6,6,6,6,6,6,6,6,6,6,6,6,6,6,6,6,6,6,6,6,6,6,6,6,6,6,6,6,6,6,6,6,6,6,6,6,6,6,6,6,6,6,6,6,6,6,6,,12,11,11,11,11,11,11,11,11,11,11,11,11,11,11,11,11,11,11,11,11,11,11,11
6,6,6,6,6,6,6,6,6,6,6,6,6,6,6,6,6,6,6,6,6,6,6,6,6,6,6,6,6,6,6,6,6,6,6,6,6,6,6,6,6,6,6,6,6,6,6,6,6,6,6,6,6,6,6,6,6,6,6,6,6,6,6,6,6,6,6,6,6,6,,12,11,11,11,11,11,11,11,11,11,11,11,11,11,11,11,11,11,11,11,11,11,11,11
6,6,6,6,6,6,6,6,6,6,6,6,6,6,6,6,6,6,6,6,6,6,6,6,6,6,6,6,6,6,6,6,6,6,6,6,6,6,6,6,6,6,6,6,6,6,6,6,6,6,6,6,6,6,6,6,6,6,6,6,6,6,6,6,6,6,6,6,6,6,,12,11,11,11,11,11,11,11,11,11,11,11,11,11,11,11,11,11,11,11,11,11,11,11
6,6,6,6,6,6,6,6,6,6,6,6,6,6,6,6,6,6,6,6,6,6,6,6,6,6,6,6,6,6,6,6,6,6,6,6,6,6,6,6,6,6,6,6,6,6,6,6,6,6,6,6,6,6,6,6,6,6,6,6,6,6,6,6,6,6,6,6,6,6,,12,11,11,11,11,11,11,11,11,11,11,11,11,11,11,11,11,11,11,11,11,11,11,11
6,6,6,6,6,6,6,6,6,6,6,6,6,6,6,6,6,6,6,6,6,6,6,6,6,6,6,6,6,6,6,6,6,6,6,6,6,6,6,6,6,6,6,6,6,6,6,6,6,6,6,6,6,6,6,6,6,6,1,1,1,1,1,1,1,1,1,1,6,6,,12,11,11,11,11,11,11,11,11,11,11,11,11,11,11,11,11,11,11,11,11,11,11,11
6,6,6,6,6,6,6,6,6,6,6,6,6,6,6,6,6,6,6,6,6,6,6,6,6,6,6,6,6,6,6,6,6,6,6,6,6,6,6,6,6,6,6,6,6,6,6,6,6,6,6,6,6,6,6,6,6,6,1,12,12,12,12,12,12,12,12,1,6,6,,12,12,11,11,11,11,11,11,11,11,11,11,11,11,11,11,11,11,11,11,11,11,11,11
6,6,6,6,6,6,6,6,6,6,6,6,6,6,6,6,6,6,,,,6,6,6,6,6,6,6,6,,,6,6,6,6,6,6,6,6,6,6,6,6,6,6,6,6,6,6,6,6,6,6,6,6,6,6,6,1,12,1,1,1,1,1,1,12,1,6,6,,,12,11,11,11,11,11,11,11,11,11,11,11,11,11,11,11,11,11,11,11,11,11,11
6,6,6,6,6,6,6,6,6,6,6,6,6,6,6,6,6,6,,,,6,6,6,6,6,6,6,6,,,6,6,6,6,6,6,6,6,6,6,6,6,6,6,6,6,6,6,6,6,6,6,6,6,6,6,6,1,12,1,1,6,6,1,1,12,1,1,6,,12,12,11,11,11,11,11,11,11,11,11,11,11,11,11,11,11,11,11,11,11,11,11,11
6,6,6,6,6,6,6,6,6,6,6,6,6,6,,,,,,,,,,,,,,,,,,,,,,,,,,,6,,,,,,,,,,,,,,,,,,,12,,6,6,6,1,12,12,12,1,6,,12,12,11,11,11,11,11,11,11,11,11,11,11,11,11,11,11,11,11,11,11,11,11,11
6,6,6,6,6,6,6,6,6,6,6,6,6,6,,,,,,,,,,,,,,,,,,,,,,,,,,,6,6,,,,,,,,,,,,,,,,,,12,,6,6,6,1,12,12,14,1,6,,,12,11,11,11,11,11,11,11,11,11,11,11,11,11,11,11,11,11,11,11,11,11,11
6,6,6,6,6,6,6,6,6,6,6,6,6,6,,,6,,,,,,,,,,,,,,,,,,,,,,,,6,6,,,,,,,,,,,,,,,,,,12,,6,6,6,1,12,12,12,1,6,,,12,11,11,11,11,11,11,11,11,11,11,11,11,11,11,11,11,11,11,11,11,11,11
6,6,6,6,6,6,6,6,6,6,6,6,6,6,,,,,,,,,,,,,,6,,,,,,,,,6,,,,6,6,,,,6,,,,,,,,,6,,,,12,12,,6,6,6,1,12,12,12,1,6,,12,12,11,11,11,11,11,11,11,11,11,11,11,11,11,11,11,11,11,11,11,11,11,11
6,6,6,6,6,6,6,6,6,6,6,6,6,6,,,,,,,,,,,,,,,,,,,,,,,,,,,6,6,,,,,,,,,,,,,,,,,12,,,6,6,6,1,1,1,1,1,6,12,12,11,11,11,11,11,11,11,11,11,11,11,11,11,11,11,11,11,11,11,11,11,11,11
6,6,6,6,6,6,6,6,6,6,6,6,6,6,,,,,,,,,,,,,,,,,,,,,,,,,,6,6,6,6,,,,,,,,,,,,,,,,12,,,6,6,6,6,6,6,6,6,6,,12,11,11,11,11,11,11,11,11,11,11,11,11,11,11,11,11,11,11,11,11,11,11,11
6,6,6,6,6,6,6,6,6,6,6,6,6,6,,6,,,,,,,,,,,,12,12,12,12,12,12,12,12,12,12,12,12,12,12,12,12,12,12,12,12,12,12,12,12,12,12,12,12,12,12,12,12,,,6,6,6,6,6,6,6,6,6,,12,11,11,11,11,11,11,11,11,11,11,11,11,11,11,11,11,11,11,11,11,11,11,11
6,6,6,6,6,6,6,6,6,6,6,6,6,6,,,,,,,,,,,,,6,12,,,,,,,,6,,,6,6,6,,6,,6,,,,,,,,,6,,,,,,,,6,6,6,6,6,6,6,6,6,12,12,11,11,11,11,11,11,11,11,11,11,11,11,11,11,11,11,11,11,11,11,11,11,11
6,6,6,6,6,6,6,6,6,6,6,6,6,6,,,,,,,,,,,,,,12,,,,,6,6,,,,,,6,6,6,6,,,,,,,,6,6,,,,,,,,6,6,6,6,6,6,6,6,6,6,6,12,12,12,11,11,11,11,11,11,11,11,11,11,11,11,11,11,11,11,11,11,11,11,11,11
6,6,6,6,6,6,6,6,6,6,6,6,6,6,6,,,7,,,,,,,,,,12,,,,,,,,,,,,6,6,,,,,,,,,,,,,,,,,,,,,6,6,6,6,6,6,6,6,6,,,12,11,11,11,11,11,11,11,11,11,11,11,11,11,11,11,11,11,11,11,11,11,11
6,6,6,6,6,6,6,6,6,6,6,6,6,6,,,,,,,,,,,,6,,12,7,,,6,,,6,,,7,,,6,,,6,,,7,,,6,,,6,,,7,,,6,,,6,6,6,6,6,6,6,6,6,6,,11,11,11,11,11,11,11,11,11,11,11,11,11,11,11,11,11,11,11,11,11,11,11
6,6,6,6,6,6,6,6,6,6,6,6,6,6,,,6,,,,,12,12,12,12,12,12,12,,,6,,,,,,,,,6,6,,,,,,,,6,,,,,,,,,6,,,,6,6,6,6,6,6,6,6,6,,,12,11,11,11,11,11,11,11,11,11,11,11,11,11,11,11,11,11,11,11,11,11,11
6,6,6,6,6,6,6,6,6,6,6,6,6,6,,,,,,,,12,,,,,,,,,,,7,,,,,,,,6,6,,,,,,,,,7,,,,,,,,,7,,6,6,6,6,6,6,6,6,6,,,12,11,11,11,11,11,11,11,11,11,11,11,11,11,11,11,11,11,11,11,11,11,11
6,6,6,6,6,6,6,6,6,6,6,6,6,,,,,,,,,12,,,,,,,,6,,,6,,,,,,6,,6,6,,,,,,6,,,6,,,,,,6,,,6,,6,6,6,6,6,6,6,6,6,,,12,11,11,11,11,11,11,11,11,11,11,11,11,11,11,11,11,11,11,11,11,11,11
6,6,6,6,6,6,6,6,6,6,6,6,6,,,,,,,,,12,,,,7,,,,,,,,,7,,,,,,6,6,,7,,,,,,,,,7,,,,,,,,,6,6,6,6,6,6,6,6,6,,12,12,11,11,11,11,11,11,11,11,11,11,11,11,11,11,11,11,11,11,11,11,11,11
6,6,6,6,6,6,6,6,6,6,6,6,6,6,,,,,,,,12,,,,6,,,,,7,,,,6,,,,,7,6,,,6,,,,,7,,,,6,,,,,7,,,,6,6,6,6,6,6,6,6,6,,12,12,11,11,11,11,11,11,11,11,11,11,11,11,11,11,11,11,11,11,11,11,11,11
6,6,6,6,6,6,6,6,6,6,6,6,6,6,,,,,,,,12,,,,,,,,,6,,,,,,,,,6,6,6,6,,,,,,6,,,,,,,,,6,,,,6,6,6,6,6,6,6,6,6,,,12,11,11,11,11,11,11,11,11,11,11,11,11,11,11,11,11,11,11,11,11,11,11
6,6,6,6,6,6,6,6,6,6,6,6,6,6,,,6,,,,,12,,,6,,,,,,,,,,,,,,,6,6,6,6,,,,,,,,,,,,,,,,,,,6,6,6,6,6,6,6,6,6,,,12,11,11,11,11,11,11,11,11,11,11,11,11,11,11,11,11,11,11,11,11,11,11
6,6,6,6,6,6,6,6,6,6,6,6,6,6,,,,,,,,12,,,,,,,,,,,,,,,,,,6,6,6,6,6,6,6,6,6,6,6,6,6,6,6,6,6,6,6,6,6,6,6,6,6,6,6,6,6,6,6,,12,12,11,11,11,11,11,11,11,11,11,11,11,11,11,11,11,11,11,11,11,11,11,11
14,14,14,14,14,14,14,14,14,14,14,14,12,12,12,12,12,12,12,12,12,12,,,,,,,6,,,,,,,,,6,,6,6,6,6,,,,6,,,,,,,,,6,,,,,,6,6,6,6,6,6,6,6,6,12,12,11,11,11,11,11,11,11,11,11,11,11,11,11,11,11,11,11,11,11,11,11,11,11
6,6,6,6,6,6,6,6,6,6,6,6,6,6,,,,,,,,12,,,,,,,,,,,6,,,,,,,6,6,6,6,,,,,,,,6,,,,,,,,,6,,6,6,6,6,6,6,6,6,6,12,12,11,11,11,11,11,11,11,11,11,11,11,11,11,11,11,11,11,11,11,11,11,11,11
6,6,6,6,6,6,6,6,6,6,6,6,6,6,,6,,,,,,12,,,,6,,,,,,,,,6,,,,,,6,,,6,,,,,,,,,6,,,,,,,,,6,6,6,6,6,6,6,6,6,,12,11,11,11,11,11,11,11,11,11,11,11,11,11,11,11,11,11,11,11,11,11,11,11
6,6,6,6,6,6,6,6,6,6,6,6,6,6,,,,,,,,12,6,,,,,,,,,,,,,,,,,,6,,,,,,,,,,,,,,,,,,,,,6,6,6,6,6,6,6,6,6,,12,11,11,11,11,11,11,11,11,11,11,11,11,11,11,11,11,11,11,11,11,11,11,11
6,6,6,6,6,6,6,6,6,6,6,6,6,6,,,,,,,,12,,,,,,,,,,6,,,,,,,,,6,,,,,,,,,6,,,,,,,,,6,,,1,1,1,1,1,1,1,1,1,1,1,1,1,1,1,1,11,11,11,11,11,11,11,11,11,11,11,11,11,11,11,11,11,11
6,6,6,6,6,6,6,6,6,6,6,6,6,6,6,,,7,,,6,12,,,6,,,7,,,,,,,,,7,,,6,6,6,,,,7,,,,,,,,,7,,,,,,,1,12,12,12,12,12,12,12,12,12,12,12,12,12,12,1,11,11,11,11,11,11,11,11,11,11,11,11,11,11,11,11,11,11
6,6,6,6,6,6,6,6,6,6,6,6,6,6,,,,,,6,,12,,,,,,,,,6,,,,,,,,,6,6,6,,,,,,,6,,,,,,,,,6,,,,1,12,12,12,12,12,12,12,12,12,12,12,12,12,12,1,11,11,11,11,11,11,11,11,11,11,11,11,11,11,11,11,11,11
6,6,6,6,6,6,6,6,6,6,6,6,6,6,,,,,,,,12,,6,,,,,,,,,,,,,,,,6,6,6,,,,,,,,,,,,,,,,,,,,1,12,12,12,12,12,12,12,12,12,12,12,12,12,12,1,11,11,11,11,11,11,11,11,11,11,11,11,11,11,11,11,11,11
6,6,6,6,6,6,6,6,6,6,6,6,6,6,,,,,6,,,12,,,,,,,,,,7,,,,,,,,6,6,6,,,,,,,,7,,,,,,,,,7,,,1,12,12,12,12,12,12,11,11,11,11,11,11,11,12,1,11,11,11,11,11,11,11,11,11,11,11,11,11,11,11,11,11,11
6,6,6,6,6,6,6,6,6,6,6,6,6,6,7,,,,,,,12,,,7,,,,,,,6,,,,,,,,6,6,,6,,,,,,,6,,,,,,,,,6,,,1,12,12,12,12,12,12,11,11,11,11,11,11,11,12,1,11,11,11,11,11,11,11,11,11,11,11,11,11,11,11,11,11,11
6,6,6,6,6,6,6,6,6,6,6,6,6,6,6,,,,,7,,12,,,6,,,,,,,,,,,,,,,6,6,6,6,,,,,,,,,,,,,,,,,,,1,12,12,12,12,12,12,11,11,12,12,12,11,11,12,1,11,11,11,11,11,11,11,11,11,11,11,11,11,11,11,11,11,11
6,6,6,6,6,6,6,6,6,6,6,6,6,6,,,,,,6,,12,12,12,12,12,12,12,12,12,12,12,12,12,12,12,12,12,12,12,12,12,12,12,12,12,12,12,12,12,12,12,12,12,12,12,12,12,12,12,12,12,12,12,12,12,12,12,11,11,12,8,12,11,11,12,1,11,11,11,11,11,11,11,11,11,11,11,11,11,11,11,11,11,11
6,6,6,6,6,6,6,6,6,6,6,6,6,6,,,6,,,,,,,,,,,,,,,,,,,,,,,6,6,6,,,,,,,,,,,,,,,,,,,,1,12,12,12,12,12,12,11,11,12,12,12,11,11,12,1,11,11,11,11,11,11,11,11,11,11,11,11,11,11,11,11,11,11
6,6,6,6,6,6,6,6,6,6,6,6,6,6,6,6,,,,,,,,,,,,,,,,,,,,,,,,6,6,,,,,,,,,,,,,,,,,,,,,1,12,12,12,12,12,12,11,11,11,11,11,11,11,12,1,11,11,11,11,11,11,11,11,11,11,11,11,11,11,11,11,11,11
6,6,6,6,6,6,6,6,6,6,6,6,6,6,,,,,,,,,,,,,,,,,,,,,,,,,,,6,,,,,,,,,,,,,,,,,,,,,1,12,12,12,12,12,12,11,11,11,11,11,11,11,12,1,11,11,11,11,11,11,11,11,11,11,11,11,11,11,11,11,11,11
6,6,6,6,6,6,6,6,6,6,6,6,6,6,,7,,,,,,6,,,,,,,,6,,,,,,,,,,,6,,,6,,,,,,,,6,,,,,,,,,,1,12,12,12,12,12,12,12,12,12,12,12,12,12,12,1,11,11,11,11,11,11,11,11,11,11,11,11,11,11,11,11,11,11
6,6,6,6,6,6,6,6,6,6,6,6,6,6,,6,,,,,,,,,,,,,,,,,,,,,,,,,6,,,,,,,,,,,,,,,,,,,,,1,12,12,12,12,12,12,12,12,12,12,12,12,12,12,1,11,11,11,11,11,11,11,11,11,11,11,11,11,11,11,11,11,11
6,6,6,6,6,6,6,6,6,6,6,6,6,6,,,,,,,,,,,,,,,,,,,,6,,,,,,,6,6,6,,,,,,,,,,,,,6,,,,,,1,12,12,12,12,12,12,12,12,12,12,12,12,12,12,1,11,11,11,11,11,11,11,11,11,11,11,11,11,11,11,11,11,11
6,6,6,6,6,6,6,6,6,6,6,6,6,,,,,,,,,,,,,,,,,,,,,,,,,6,,,6,6,6,,,,,,,,,,,,,,,,,6,,1,1,1,1,1,1,1,1,1,1,1,1,1,1,1,1,11,11,11,11,11,11,11,11,11,11,11,11,11,11,11,11,11,11
6,6,6,6,6,6,6,6,6,6,6,6,6,,,,6,,,,6,,,,,,,,,,6,,,,,,,,,,6,6,6,,,,,,,,,,6,,,,,,,,,6,6,6,6,6,6,6,6,12,11,11,11,11,11,11,11,11,11,11,11,11,11,11,11,11,11,11,11,11,11,11,11,11,11
6,6,6,6,6,6,6,6,6,6,6,6,6,6,,,,,,,,,,,,,6,6,,,,,,,,,,,,,6,,,,,,,,6,6,,,,,,,,,,,,6,6,6,6,6,6,6,6,12,11,11,11,11,11,11,11,11,11,11,11,11,11,11,11,11,11,11,11,11,11,11,11,11,11
6,6,6,6,6,6,6,6,6,6,6,6,6,6,,,,,,,,,,,,,,,,,,,,,,,6,,,,6,,,,,,,,,,,,,,,,,,6,,,6,6,6,6,6,6,6,6,12,11,11,11,11,11,11,11,11,11,11,11,11,11,11,11,11,11,11,11,11,11,11,11,11,11
6,6,6,6,6,6,6,6,6,6,6,6,6,6,,6,,,,6,,,7,,,6,,,,6,,,7,,,,,,,6,6,6,,,7,,,6,,,,6,,,7,,,,,,,6,6,6,6,6,6,6,6,12,11,11,11,11,11,11,11,11,11,11,11,11,11,11,11,11,11,11,11,11,11,11,11,11,11
6,6,6,6,6,6,6,6,6,6,6,6,6,6,,,6,,,,,,,,6,,,,,,,,,,,6,,,,,6,6,,,,,6,,,,,,,,,,,6,,,,6,6,6,6,6,6,6,,12,11,11,11,11,11,11,11,11,11,11,11,11,11,11,11,11,11,11,11,11,11,11,11,11,11
6,6,6,6,6,6,6,6,6,6,6,6,6,6,6,6,,,6,,,,,,,,7,,6,,,,,,,,,,,,6,6,,,,,,,7,,6,,,,,,,,,,,,,,,,,,,12,11,11,11,11,11,11,11,11,11,11,11,11,11,11,11,11,11,11,11,11,11,11,11,11,11
6,6,6,6,6,6,6,6,6,6,6,6,6,6,,,,,,,,,,6,,,6,,,,,,,,,,7,,,,6,,,,,6,,,6,,,,,,,,,,7,,,6,6,6,6,6,6,6,12,12,11,11,11,11,11,11,11,11,11,11,11,11,11,11,11,11,11,11,11,11,11,11,11,11,11
6,6,6,6,6,6,6,6,6,6,6,6,6,6,,7,,,,7,,,,,,,,,,7,,,,,,,6,,,7,6,7,,,,,,,,,,7,,,,,,,6,,,6,6,6,6,6,,,12,12,11,11,11,11,11,11,11,11,11,11,11,11,11,11,11,11,11,11,11,11,11,11,11,11,11
6,6,6,6,6,6,6,6,6,6,6,6,6,6,,6,,,,6,,,,,7,,,,,6,,,,,,,,,,6,6,6,,,,,7,,,,,6,,,,,,,,,,6,6,6,6,12,12,12,12,12,11,11,11,11,11,11,11,11,11,11,11,11,11,11,11,11,11,11,11,11,11,11,11,11,11
6,6,6,6,6,6,6,6,6,6,6,6,6,6,,,,,,,,,,,6,,,,,,,,,,,,,,,,6,,,,,,6,,,,,,,,,,,,,,,6,6,6,6,11,11,11,11,11,11,11,11,11,11,11,11,11,11,11,11,11,11,11,11,11,11,11,11,11,11,11,11,11,11
6,6,6,6,6,6,6,6,6,6,6,6,6,6,6,6,6,6,,,6,6,6,6,6,6,6,6,6,6,6,6,,,6,6,6,6,6,6,6,6,6,6,,,6,6,6,6,6,6,6,,,6,6,6,6,6,6,6,6,6,6,11,11,11,11,11,11,11,11,11,11,11,11,11,11,11,11,11,11,11,11,11,11,11,11,11,11,11,11,11,11
6,6,6,6,6,6,6,6,6,6,6,6,6,6,6,6,6,6,6,6,6,6,6,6,6,6,6,6,6,6,6,6,,,6,6,6,6,6,6,6,6,6,6,6,6,6,6,6,6,6,6,6,,,6,6,6,6,6,6,6,6,6,6,11,11,11,11,11,11,11,11,11,11,11,11,11,11,11,11,11,11,11,11,11,11,11,11,11,11,11,11,11,11
6,6,6,6,6,6,6,6,6,6,6,6,6,6,6,6,6,6,6,6,6,6,6,6,6,6,6,6,6,6,6,6,6,6,6,6,6,6,6,6,6,6,6,6,6,6,6,6,6,6,6,6,6,6,6,6,6,6,6,6,6,6,6,6,6,11,11,11,11,11,11,11,11,11,11,11,11,11,11,11,11,11,11,11,11,11,11,11,11,11,11,11,11,11,11
6,6,6,6,6,6,6,6,6,6,6,6,6,6,6,6,6,6,6,6,6,6,6,6,6,6,6,6,6,6,6,6,6,6,6,6,6,6,6,6,6,6,6,6,6,6,6,6,6,6,6,6,6,6,6,6,6,6,6,6,6,6,6,11,11,11,11,11,11,11,11,11,11,11,11,11,11,11,11,11,11,11,11,11,11,11,11,11,11,11,11,11,11,11,11
6,6,6,6,6,6,6,6,6,6,6,6,6,6,6,6,6,6,6,6,6,6,6,6,6,6,6,6,6,6,6,6,6,6,6,6,6,6,6,6,6,6,6,6,6,6,6,6,6,6,6,6,6,6,6,6,6,6,6,6,6,6,6,11,11,11,11,11,11,11,11,11,11,11,11,11,11,11,11,11,11,11,11,11,11,11,11,11,11,11,11,11,11,11,11
6,6,6,6,6,6,6,6,6,6,6,6,6,6,6,6,6,6,6,6,6,6,6,6,6,6,6,6,6,6,6,6,6,6,6,6,6,6,6,6,6,6,6,6,6,6,6,6,6,6,6,6,6,6,6,6,6,6,6,6,6,6,6,11,11,11,11,11,11,11,11,11,11,11,11,11,11,11,11,11,11,11,11,11,11,11,11,11,11,11,11,11,11,11,11
6,6,6,6,6,6,6,6,6,6,6,6,6,6,6,6,6,6,6,6,6,6,6,6,6,6,6,6,6,6,6,6,6,6,6,6,6,6,6,6,6,6,6,6,6,6,6,6,6,6,6,6,6,6,6,6,6,6,6,6,6,6,6,11,11,11,11,11,11,11,11,11,11,11,11,11,11,11,11,11,11,11,11,11,11,11,11,11,11,11,11,11,11,11,11
6,6,6,6,6,6,6,6,6,6,6,6,6,6,6,6,6,6,6,6,6,6,6,6,6,6,6,6,6,6,6,6,6,6,6,6,6,6,6,6,6,6,6,6,6,6,6,6,6,6,6,6,6,6,6,6,6,6,6,6,6,6,6,11,11,11,11,11,11,11,11,11,11,11,11,11,11,11,11,11,11,11,11,11,11,11,11,11,11,11,11,11,11,11,11
6,6,6,6,6,6,6,6,6,6,6,6,6,6,6,6,6,6,6,6,6,6,6,6,6,6,6,6,6,6,6,6,6,6,6,6,6,6,6,6,6,6,6,6,6,6,6,6,6,6,6,6,6,6,6,6,6,6,6,6,6,11,11,11,11,11,11,11,11,11,11,11,11,11,11,11,11,11,11,11,11,11,11,11,11,11,11,11,11,11,11,11,11,11,11
6,6,6,6,6,6,6,6,6,6,6,6,6,6,6,6,6,6,6,6,6,6,6,6,6,6,6,6,6,6,6,6,6,6,6,6,6,6,6,6,6,6,6,6,6,6,6,6,6,6,6,6,6,6,6,6,6,6,6,6,6,11,11,11,11,11,11,11,11,11,11,11,11,11,11,11,11,11,11,11,11,11,11,11,11,11,11,11,11,11,11,11,11,11,11
6,6,6,6,6,6,6,6,6,6,6,6,6,6,6,6,6,6,6,6,6,6,6,6,6,6,6,6,6,6,6,6,6,6,6,6,6,6,6,6,6,6,6,6,6,6,6,6,6,6,6,6,6,6,6,6,6,6,6,6,6,11,11,11,11,11,11,11,11,11,11,11,11,11,11,11,11,11,11,11,11,11,11,11,11,11,11,11,11,11,11,11,11,11,11
6,6,6,6,6,6,6,6,6,6,6,6,6,6,6,6,6,6,6,6,6,6,6,6,6,6,6,6,6,6,6,6,6,6,6,6,6,6,6,6,6,6,6,6,6,6,6,6,6,6,6,6,6,6,6,6,6,6,6,6,6,11,11,11,11,11,11,11,11,11,11,11,11,11,11,11,11,11,11,11,11,11,11,11,11,11,11,11,11,11,11,11,11,11,11
6,6,6,6,6,6,6,6,6,6,6,6,6,6,6,6,6,6,6,6,6,6,6,6,6,6,6,6,6,6,6,6,6,6,6,6,6,6,6,6,6,6,6,6,6,6,6,6,6,6,6,6,6,6,6,6,6,6,6,6,6,11,11,11,11,11,11,11,11,11,11,11,11,11,11,11,11,11,11,11,11,11,11,11,11,11,11,11,11,11,11,11,11,11,11
11,11,11,11,11,11,11,11,11,11,11,11,11,11,11,11,11,11,11,11,11,11,11,11,11,11,11,11,11,11,11,11,11,11,11,11,11,11,11,11,11,11,11,11,11,11,11,11,11,11,11,11,11,11,11,11,11,11,11,11,11,11,11,11,11,11,11,11,11,11,11,11,11,11,11,11,11,11,11,11,11,11,11,11,11,11,11,11,11,11,11,11,11,11,11
11,11,11,11,11,11,11,11,11,11,11,11,11,11,11,11,11,11,11,11,11,11,11,11,11,11,11,11,11,11,11,11,11,11,11,11,11,11,11,11,11,11,11,11,11,11,11,11,11,11,11,11,11,11,11,11,11,11,11,11,11,11,11,11,11,11,11,11,11,11,11,11,11,11,11,11,11,11,11,11,11,11,11,11,11,11,11,11,11,11,11,11,11,11,11